1111111
1P00XE1
1011101
1C00001
1011011
1111111
