1111111
1P00XE1
1011111
1C00001
1011011
1111111
