111111
100XP1
1011C1
100E01
111111
