111111
1X0P01
1011C1
100E01
111111
