111111111111111111
1P0000000000000011
101111101111110101
1C000C000C000C0001
101111111101111101
100000000000000E01
111111101111111101
1C000C000C000C00E1
111111111111111111
