1111111111111111
1P00000000000001
1011111111111101
1C000C000C000001
1011011111011101
100C000000000C01
1111011111111011
1C000000C00000E1
1111111111111111
