1111111
1P00001
1011101
1C0CE01
1011101
1111111
