111111111111111
1X00000P0000001
101111111111101
1C00000000C0001
101111101111101
1C000C001000001
101101111111101
100C000C00000E1
111111111111111
