111111111111111111111
1P0000000100000000001
101111111011011111111
1C000C0X1110000000001
1011111C1111111111101
1CCCCCCCCCCCCCCCCCCC1
111111111101111111101
1C000C000C000000C0001
1011111111E11111111C1
100000000000000000001
111111111111111111111
