111111111111111111111111
1P0000000000000011111111
100011111111100001111111
1000C0000000C00001111111
111100011111110000011111
111100010000011100011111
100000010CEC001100011111
100000010000001100011111
101111111011111111001111
100000000000000000001111
100011111111111110001111
1000C00000000000C0001111
111111111111111111111111
