1111111111111
1C0P0000000E1
1111111111111
