111111111111111111111111111111111111111111111111111111111111111111111111111111111111111111111
1P0000000000000011111111111111111111111111111111111111111111111111111111111111111111111111111
100011111111100000000000000000000000000000000000000011111111111111111111111111111111111111111
1000C0000000C00001111111111111111111111111111111111C11111111111111111111111111111111111111111
11110001111111CCCCCCCCCCCCCCCCCCCCCCCCCCCCCCCCCCCCCC11111111111111111111111111111111111111111
1111000100000111000CCCCCCCCCCCCCCCCCCCCCCCCCCCCCCCCCCCCCCCCCCCCCCCCCCCCCCCCCCCCCCCCCCCCCCCCC1
100000010CEC0011000CCCCCCCCCCCCCCCCCCCCCCCCCCCCCCCCCCCCCCCCCCCCCCCCCCCCCCCCCCCCCCCCCCCCCCCCC1
1000000100000011000CCCCCCCCCCCCCCCCCCCCCCCCCCCCCCCCCCCCCCCCCCCCCCCCCCCCCCCCCCCCCCCCCCCCCCCCC1
10111111101111111100CCCCCCCCCCCCCCCCCCCCCCCCCCCCCCCCCCCCCCCCCCCCCCCCCCCCCCCCCCCCCCCCCCCCCCCC1
100000000000000000001111111111111111111111111111111111111111111111111111111111111111111111111
100011111111111110001111111111111111111111111111111111111111111111111111111111111111111111111
1000C00000000000C0001111111111111111111111111111111111111111111111111111111111111111111111111
111111111111111111111111111111111111111111111111111111111111111111111111111111111111111111111
