1111111111
1P100C0001
1000000001
1000101011
1E10C000C1
1111111111
