111111111111
1P0000000001
100000111111
100000000001
101111C000C1
100000000001
1000000E0001
111111111111
