111111111
1P0100001
11011E111
10100C001
111111111
