111111111111
1P0001000001
1000001111111
1010000000C01
1011111111111
10C0000000C01
1E00000000001
111111111111
