111111
1P0001
1000011
1E0001
111111
