111111111
1P0001001
100001C01
100000001
1E1001001
111111111
