111111111
1PC001001
100001001
100000001
1E1001101
111111111
